AAAA/wAAAP8AAAD/AAAA/wAAAP8AAAD/AAAA/wAAAP8AAAD/AAAA/wAAAP8AAAD/AAAA/wAAAP8A
AAD/AAAA/wAAAP8AAAD/AAAA/wAAAP8AAAD/AAAA/wAAAP8AAAD/AAAA/wAAAP8AAAD/AAAA/wAA
AP8AAAD/AAAA/wAAAP8AAAD/AAAA/wAAAP8AAAD/AAAA/wAAAP8AAAD/AAAA/wAAAP8AAAD/AAAA
/wAAAP8AAAD/AAAA/wAAAP8AAAD/AAAA/wAAAP8AAAD/AAAA/wAAAP8AAAD/AAAA/wAAAP8AAAD/
AAAA/wAAAP8AAAD/AAAA/wAAAP8AAAD/AAAA/wAAAP8AAAD/AAAA/wAAAP8AAAD/AAAA/wAAAP8A
AAD/AAAA/wAAAP8AAAD/AAAA/wAAAP8AAAD/AAAA/wAAAP8AAAD/AAAA/wAAAP8AAAD/AAAA/wAA
AP8AAAD/AAAA/wAAAP8AAAD/AAAA/wAAAP8AAAD/AAAA/wAAAP8AAAD/AAAA/wAAAP8AAAD/AAAA
/wAAAP8AAAAA////AP///wD///8A////AP///wD///8A////AP///wD///8A////AP///wD///8A
////AP///wD///8A////AP///wD///8A////AP///wD///8A////AP///wD///8A////AP///wD/
//8A////AP///wD///8A////AP///wD///8A////AP///wD///8A////AP///wD///8A////AP//
/wD///8A////AP///wD///8A////AP///wD///8A////AP///wD///8A////AP///wD///8A////
AP///wD///8A////AP///wD///8A////AP///wD///8A////AP///wD///8A////AP///wD///8A
////AP///wD///8A////AP///wD///8A////AP///wD///8A////AP///wD///8A////AP///wD/
//8A////AP///wD///8A////AP///wD///8A////AP///wD///8A////AP///wD///8A////AAAA
AP8AAAD/////AP///wD///8A////AP///wD///8A////AP///wD///8A////AP///wD///8A////
AP///wD///8A////AP///wD///8A////AP///wD///8A////AP///wD///8A////AP///wD///8A
////AP///wD///8A////AP///wD///8A////AP///wD///8A////AP///wD///8A////AP///wD/
//8A////AP///wD///8A////AP///wD///8A////AP///wD///8A////AP///wD///8A////AP//
/wD///8A////AP///wD///8A////AP///wD///8A////AP///wD///8A////AP///wD///8A////
AP///wD///8A////AP///wD///8A////AP///wD///8A////AP///wD///8A////AP///wD///8A
////AP///wD///8A////AP///wD///8A////AP///wD///8A////AP///wD///8A////AP///wAA
AAD/AAAA/////wD///8A////AP///wD///8A////AP///wD///8A////AP///wD///8A////AP//
/wD///8A////AP///wD///8A////AP///wD///8A////AP///wD///8A////AP///wD///8A////
AP///wD///8A////AP///wD///8A////AP///wD///8A////AP///wD///8A////AP///wD///8A
////AP///wD///8A////AP///wD///8A////AP///wD///8A////AP///wD///8A////AP///wD/
//8A////AP///wD///8A////AP///wD///8A////AP///wD///8A////AP///wD///8A////AP//
/wD///8A////AP///wD///8A////AP///wD///8A////AP///wD///8A////AP///wD///8A////
AP///wD///8A////AP///wD///8A////AP///wD///8A////AP///wD///8A////AP///wD///8A
AAAA/wAAAP////8A////AP///wD///8A////AP///wD///8A////AP///wD///8A////AP///wD/
//8A////AP///wD///8A////AP///wD///8A////AP///wD///8A////AP///wD///8A////AP//
/wD///8A////AP///wD///8A////AP///wD///8A////AP///wD///8A////AP///wD///8A////
AP///wD///8A////AP///wD///8A////AP///wD///8A////AP///wD///8A////AP///wD///8A
////AP///wD///8A////AP///wD///8A////AP///wD///8A////AP///wD///8A////AP///wD/
//8A////AP///wD///8A////AP///wD///8A////AP///wD///8A////AP///wD///8A////AP//
/wD///8A////AP///wD///8A////AP///wD///8A////AP///wD///8A////AP///wD///8A////
AAAAAP8AAAD/////AP///wD///8A////AP///wD///8A////AP///wD///8A////AP///wD///8A
////AP///wD///8A////AP///wD///8A////AP///wD///8A////AP///wD///8A////AP///wD/
//8A////AP///wD///8A////AP///wD///8A////AP///wD///8A////AP///wD///8A////AP//
/wD///8A////AP///wD///8A////AP///wD///8A////AP///wD///8A////AP///wD///8A////
AP///wD///8A////AP///wD///8A////AP///wD///8A////AP///wD///8A////AP///wD///8A
////AP///wD///8A////AP///wD///8A////AP///wD///8A////AP///wD///8A////AP///wD/
//8A////AP///wD///8A////AP///wD///8A////AP///wD///8A////AP///wD///8A////AP//
/wAAAAD/AAAA/////wD///8A////AP///wD///8A////AP///wD///8A////AP///wD///8A////
AP///wD///8A////AP///wD///8A////AP///wD///8A////AP///wD///8A////AP///wD///8A
////AP///wD///8A////AP///wD///8A////AP///wD///8A////AP///wD///8A////AP///wD/
//8A////AP///wD///8A////AP///wD///8A////AP///wD///8A////AP///wD///8A////AP//
/wD///8A////AP///wD///8A////AP///wD///8A////AP///wD///8A////AP///wD///8A////
AP///wD///8A////AP///wD///8A////AP///wD///8A////AP///wD///8A////AP///wD///8A
////AP///wD///8A////AP///wD///8A////AP///wD///8A////AP///wD///8A////AP///wD/
//8AAAAA/wAAAP8AAAAAAAAAAAAAAAAAAAAAAAAAAAAAAAAAAAAAAAAAAAAAAAAAAAAAAAAAAAAA
AAAAAAAAAAAAAAAAAAAAAAAAAAAAAAAAAAAAAAAAAAAAAAAAAAAAAAAAAAAAAAAAAAAAAAAAAAAA
AAAAAAAAAAAAAAAAAAAAAAAAAAAAAAAAAAAAAAAAAAAAAAAAAAAAAAAAAAAAAAAAAAAAAAAAAAAA
AAAAAAAAAAAAAAAAAAAAAAAAAAAAAAAAAAAAAAAAAAAAAAAAAAAAAAAAAAAAAAAAAAAAAAAAAAAA
AAAAAAAAAAAAAAAAAAAAAAAAAAAAAAAAAAAAAAAAAAAAAAAAAAAAAAAAAAAAAAAAAAAAAAAAAAAA
AAAAAAAAAAAAAAAAAAAAAAAAAAAAAAAAAAAAAAAAAAAAAAAAAAAAAAAAAAAAAAAAAAAAAAAAAAAA
AAAAAAAAAAAAAAAAAAAAAAAAAAAAAAAAAAAAAAAAAAAAAAAAAAAAAAAAAAAAAAAAAAAAAAAAAAAA
AAAAAAAAAP8AAAD/////AP///wD///8A////AP///wD///8A////AP///wD///8A////AP///wD/
//8A////AP///wD///8A////AP///wD///8A////AP///wD///8A////AP///wD///8A////AP//
/wD///8A////AP///wD///8A////AP///wD///8A////AP///wD///8A////AP///wD///8A////
AP///wD///8A////AP///wD///8A////AP///wD///8A////AP///wD///8A////AP///wD///8A
////AP///wD///8A////AP///wD///8A////AP///wD///8A////AP///wD///8A////AP///wD/
//8A////AP///wD///8A////AP///wD///8A////AP///wD///8A////AP///wD///8A////AP//
/wD///8A////AP///wD///8A////AP///wD///8A////AP///wD///8A////AP///wD///8A////
AP///wAAAAD/AAAA/////wD///8A////AP///wD///8A////AP///wD///8A////AP///wD///8A
////AP///wD///8A////AP///wD///8A////AP///wD///8A////AP///wD///8A////AP///wD/
//8A////AP///wD///8A////AP///wD///8A////AP///wD///8A////AP///wD///8A////AP//
/wD///8A////AP///wD///8A////AP///wD///8A////AP///wD///8A////AP///wD///8A////
AP///wD///8A////AP///wD///8A////AP///wD///8A////AP///wD///8A////AP///wD///8A
////AP///wD///8A////AP///wD///8A////AP///wD///8A////AP///wD///8A////AP///wD/
//8A////AP///wD///8A////AP///wD///8A////AP///wD///8A////AP///wD///8A////AP//
/wD///8AAAAA/wAAAP////8A////AP///wD///8A////AP///wD///8A////AP///wD///8A////
AP///wD///8A////AP///wD///8A////AP///wD///8A////AP///wD///8A////AP///wD///8A
////AP///wD///8A////AP///wD///8A////AP///wD///8A////AP///wD///8A////AP///wD/
//8A////AP///wD///8A////AP///wD///8A////AP///wD///8A////AP///wD///8A////AP//
/wD///8A////AP///wD///8A////AP///wD///8A////AP///wD///8A////AP///wD///8A////
AP///wD///8A////AP///wD///8A////AP///wD///8A////AP///wD///8A////AP///wD///8A
////AP///wD///8A////AP///wD///8A////AP///wD///8A////AP///wD///8A////AP///wD/
//8A////AAAAAP8AAAD/////AP///wD///8A////AP///wD///8A////AP///wD///8A////AP//
/wD///8A////AP///wD///8A////AP///wD///8A////AP///wD///8A////AP///wD///8A////
AP///wD///8A////AP///wD///8A////AP///wD///8A////AP///wD///8A////AP///wD///8A
////AP///wD///8A////AP///wD///8A////AP///wD///8A////AP///wD///8A////AP///wD/
//8A////AP///wD///8A////AP///wD///8A////AP///wD///8A////AP///wD///8A////AP//
/wD///8A////AP///wD///8A////AP///wD///8A////AP///wD///8A////AP///wD///8A////
AP///wD///8A////AP///wD///8A////AP///wD///8A////AP///wD///8A////AP///wD///8A
////AP///wAAAAD/AAAA/////wD///8A////AP///wD///8A////AP///wD///8A////AP///wD/
//8A////AP///wD///8A////AP///wD///8A////AP///wD///8A////AP///wD///8A////AP//
/wD///8A////AP///wD///8A////AP///wD///8A////AP///wD///8A////AP///wD///8A////
AP///wD///8A////AP///wD///8A////AP///wD///8A////AP///wD///8A////AP///wD///8A
////AP///wD///8A////AP///wD///8A////AP///wD///8A////AP///wD///8A////AP///wD/
//8A////AP///wD///8A////AP///wD///8A////AP///wD///8A////AP///wD///8A////AP//
/wD///8A////AP///wD///8A////AP///wD///8A////AP///wD///8A////AP///wD///8A////
AP///wD///8AAAAA/wAAAP////8A////AP///wD///8A////AP///wD///8A////AP///wD///8A
////AP///wD///8A////AP///wD///8A////AP///wD///8A////AP///wD///8A////AP///wD/
//8A////AP///wD///8A////AP///wD///8A////AP///wD///8A////AP///wD///8A////AP//
/wD///8A////AP///wD///8A////AP///wD///8A////AP///wD///8A////AP///wD///8A////
AP///wD///8A////AP///wD///8A////AP///wD///8A////AP///wD///8A////AP///wD///8A
////AP///wD///8A////AP///wD///8A////AP///wD///8A////AP///wD///8A////AP///wD/
//8A////AP///wD///8A////AP///wD///8A////AP///wD///8A////AP///wD///8A////AP//
/wD///8A////AAAAAP8AAAD/////AP///wD///8A////AP///wD///8A////AP///wD///8A////
AP///wD///8A////AP///wD///8A////AP///wD///8A////AP///wD///8A////AP///wD///8A
////AP///wD///8A////AP///wD///8A////AP///wD///8A////AP///wD///8A////AP///wD/
//8A////AP///wD///8A////AP///wD///8A////AP///wD///8A////AP///wD///8A////AP//
/wD///8A////AP///wD///8A////AP///wD///8A////AP///wD///8A////AP///wD///8A////
AP///wD///8A////AP///wD///8A////AP///wD///8A////AP///wD///8A////AP///wD///8A
////AP///wD///8A////AP///wD///8A////AP///wD///8A////AP///wD///8A////AP///wD/
//8A////AP///wAAAAD/AAAA/////wD///8A////AP///wD///8A////AP///wD///8A////AP//
/wD///8A////AP///wD///8A////AP///wD///8A////AP///wD///8A////AP///wD///8A////
AP///wD///8A////AP///wD///8A////AP///wD///8A////AP///wD///8A////AP///wD///8A
////AP///wD///8A////AP///wD///8A////AP///wD///8A////AP///wD///8A////AP///wD/
//8A////AP///wD///8A////AP///wD///8A////AP///wD///8A////AP///wD///8A////AP//
/wD///8A////AP///wD///8A////AP///wD///8A////AP///wD///8A////AP///wD///8A////
AP///wD///8A////AP///wD///8A////AP///wD///8A////AP///wD///8A////AP///wD///8A
////AP///wD///8AAAAA/wAAAP////8A////AP///wD///8A////AP///wD///8A////AP///wD/
//8A////AP///wD///8A////AP///wD///8A////AP///wD///8A////AP///wD///8A////AP//
/wD///8A////AP///wD///8A////AP///wD///8A////AP///wD///8A////AP///wD///8A////
AP///wD///8A////AP///wD///8A////AP///wD///8A////AP///wD///8A////AP///wD///8A
////AP///wD///8A////AP///wD///8A////AP///wD///8A////AP///wD///8A////AP///wD/
//8A////AP///wD///8A////AP///wD///8A////AP///wD///8A////AP///wD///8A////AP//
/wD///8A////AP///wD///8AAAAA/wAAAP8AAAD/AAAA/////wD///8A////AP///wD///8A////
AP///wD///8A////AAAAAP8AAAD/////AP///wD///8A////AP///wD///8A////AP///wD///8A
////AP///wD///8A////AP///wD///8A////AP///wD///8A////AP///wD///8A////AP///wD/
//8A////AP///wD///8A////AP///wD///8A////AP///wD///8A////AP///wD///8A////AP//
/wD///8A////AP///wD///8A////AP///wD///8A////AP///wD///8A////AP///wD///8A////
AP///wD///8A////AP///wD///8A////AP///wD///8A////AP///wD///8A////AP///wD///8A
////AP///wD///8A////AP///wD///8A////AP///wD///8A////AP///wD///8A////AP///wD/
//8A////AP///wD///8A////AP///wD///8A////AP///wD///8A////AP///wD///8A////AP//
/wD///8A////AP///wAAAAD/AAAA/////wD///8A////AP///wD///8A////AP///wD///8A////
AP///wD///8A////AP///wD///8A////AP///wD///8A////AP///wD///8A////AP///wD///8A
////AP///wD///8A////AP///wD///8A////AP///wD///8A////AP///wD///8A////AP///wD/
//8A////AP///wD///8A////AAAAAP8AAAD/AAAA/wAAAP8AAAD/AAAA/wAAAP8AAAD/////AP//
/wD///8A////AP///wD///8A////AP///wD///8A////AP///wD///8A////AP///wD///8A////
AP///wD///8A////AP///wD///8A////AP///wD///8A////AP///wD///8AAAAA/wAAAP8AAAD/
AAAA/wAAAP8AAAD/AAAA/////wD///8A////AP///wD///8A////AP///wD///8A////AP///wD/
//8A////AP///wD///8AAAAA/wAAAP////8A////AP///wD///8A////AP///wD///8A////AP//
/wD///8A////AP///wD///8A////AP///wD///8A////AP///wD///8A////AP///wD///8A////
AP///wD///8A////AP///wD///8A////AP///wD///8A////AP///wD///8A////AP///wD///8A
////AP///wD///8A////AP///wD///8A////AP///wD///8A////AP///wD///8A////AP///wD/
//8A////AP///wD///8A////AP///wD///8A////AP///wD///8A////AP///wD///8A////AP//
/wD///8A////AP///wD///8A////AP///wD///8A////AP///wD///8A////AAAAAP////8A////
AP///wD///8A////AP///wD///8A////AP///wD///8A////AP///wD///8AAAAA/wAAAP8AAAD/
AAAA/////wD///8A////AAAAAP8AAAD/////AP///wD///8A////AP///wD///8A////AP///wAA
AAD/AAAA/wAAAP8AAAD/AAAA/wAAAP8AAAD/AAAA/wAAAP8AAAD/AAAA/wAAAP8AAAD/AAAA/wAA
AP8AAAD/AAAA/wAAAP8AAAD/AAAA/wAAAP8AAAD/////AP///wD///8A////AP///wD///8A////
AP///wD///8A////AP///wD///8A////AP///wD///8A////AP///wD///8A////AP///wD///8A
////AP///wD///8A////AP///wD///8A////AP///wD///8A////AP///wD///8A////AP///wD/
//8A////AP///wD///8A////AP///wD///8A////AP///wD///8A////AP///wAAAAD/////AP//
/wD///8A////AP///wD///8A////AP///wD///8A////AP///wD///8A////AP///wD///8A////
AP///wD///8A////AP///wAAAAD/AAAA/////wD///8A////AP///wD///8A////AAAAAP8AAAD/
////AP///wD///8A////AP///wD///8A////AP///wD///8A////AP///wD///8A////AP///wD/
//8A////AP///wD///8A////AP///wD///8A////AP///wD///8A////AAAAAP8AAAD/AAAA/wAA
AP8AAAD/AAAA/wAAAP8AAAD/////AP///wD///8A////AP///wD///8A////AP///wD///8A////
AP///wD///8A////AP///wD///8A////AP///wD///8A////AP///wD///8A////AP///wD///8A
////AP///wD///8A////AP///wD///8A////AP///wD///8A////AP///wD///8AAAAA/////wD/
//8A////AP///wD///8A////AP///wD///8A////AP///wD///8A////AP///wD///8A////AP//
/wD///8A////AP///wD///8AAAAA/wAAAP////8A////AP///wD///8A////AP///wD///8A////
AP///wD///8A////AP///wD///8A////AP///wD///8A////AP///wD///8A////AP///wD///8A
////AP///wD///8A////AP///wD///8A////AP///wD///8A////AP///wD///8A////AP///wD/
//8A////AP///wD///8A////AP///wD///8A////AP///wD///8A////AP///wD///8A////AP//
/wD///8A////AP///wD///8A////AP///wD///8A////AP///wD///8A////AP///wD///8A////
AP///wD///8A////AP///wD///8A////AP///wD///8A////AP///wD///8A////AAAAAP////8A
////AP///wD///8A////AP///wD///8A////AAAAAP8AAAD/AAAA/wAAAP8AAAD/////AP///wD/
//8A////AP///wD///8A////AAAAAP8AAAD/////AP///wD///8A////AP///wD///8A////AP//
/wD///8A////AP///wD///8A////AP///wD///8A////AP///wD///8A////AP///wD///8A////
AP///wD///8A////AP///wD///8A////AP///wD///8A////AP///wD///8A////AP///wD///8A
////AP///wD///8A////AP///wD///8A////AP///wD///8A////AP///wD///8A////AP///wD/
//8A////AP///wD///8A////AP///wD///8A////AP///wD///8A////AP///wD///8A////AP//
/wD///8A////AP///wD///8A////AP///wD///8A////AP///wD///8A////AP///wAAAAD/////
AP///wD///8A////AP///wD///8A////AP///wD///8A////AP///wD///8A////AP///wD///8A
////AP///wD///8A////AP///wAAAAD/AAAA/wAAAP8AAAD/AAAA/wAAAP8AAAD/////AP///wD/
//8A////AP///wD///8A////AP///wD///8A////AP///wD///8A////AP///wD///8A////AP//
/wD///8A////AP///wD///8A////AP///wD///8A////AP///wD///8A////AP///wD///8A////
AP///wD///8A////AP///wD///8A////AP///wD///8A////AP///wD///8A////AP///wD///8A
////AP///wD///8A////AP///wD///8A////AP///wD///8A////AP///wD///8A////AP///wD/
//8A////AP///wD///8A////AP///wD///8A////AP///wD///8A////AP///wD///8AAAAA/wAA
AP8AAAD/AAAA/wAAAP8AAAD/////AP///wD///8A////AP///wD///8A////AP///wD///8A////
AP///wD///8A////AP///wD///8AAAAA/wAAAP////8A////AP///wD///8A////AAAAAP8AAAD/
////AP///wD///8A////AP///wD///8A////AP///wD///8A////AP///wD///8A////AP///wD/
//8A////AP///wD///8A////AP///wD///8A////AP///wD///8A////AP///wD///8A////AP//
/wD///8A////AP///wD///8A////AP///wD///8A////AP///wD///8A////AP///wAAAAD/AAAA
/wAAAP8AAAD/AAAA/////wD///8A////AP///wD///8A////AP///wD///8A////AP///wD///8A
////AP///wD///8A////AP///wD///8A////AP///wD///8A////AP///wD///8A////AP///wD/
//8A////AP///wD///8A////AP///wD///8A////AP///wD///8A////AP///wD///8A////AP//
/wD///8A////AP///wD///8A////AAAAAP8AAAD/////AP///wD///8A////AP///wD///8A////
AAAAAP8AAAD/////AP///wD///8A////AP///wD///8A////AP///wD///8A////AP///wD///8A
////AP///wD///8A////AP///wD///8A////AP///wD///8A////AP///wD///8A////AP///wD/
//8A////AP///wD///8A////AP///wD///8A////AP///wD///8A////AP///wD///8A////AP//
/wD///8A////AAAAAP8AAAD/AAAA/////wD///8A////AP///wD///8A////AP///wD///8A////
AP///wD///8A////AP///wD///8A////AP///wD///8A////AP///wD///8A////AP///wD///8A
////AP///wD///8A////AP///wD///8A////AP///wD///8A////AAAAAP8AAAD/AAAA/wAAAP8A
AAD/////AP///wD///8A////AP///wAAAAD/AAAA/////wD///8A////AP///wD///8A////AP//
/wD///8A////AAAAAP8AAAD/AAAA/wAAAP////8A////AP///wD///8A////AP///wD///8A////
AP///wD///8A////AP///wD///8A////AP///wD///8A////AP///wD///8A////AP///wD///8A
////AP///wD///8A////AP///wD///8A////AP///wD///8A////AP///wD///8A////AP///wD/
//8A////AP///wD///8A////AP///wD///8A////AP///wAAAAD/AAAA/wAAAP8AAAD/AAAA/wAA
AP8AAAD/////AP///wD///8A////AP///wD///8A////AP///wD///8A////AP///wD///8A////
AP///wD///8A////AP///wD///8A////AP///wD///8A////AP///wD///8A////AP///wD///8A
AAAA/wAAAP////8A////AP///wD///8AAAAA/wAAAP////8A////AP///wD///8A////AP///wD/
//8A////AP///wD///8A////AP///wD///8A////AP///wD///8A////AP///wD///8A////AP//
/wD///8A////AP///wD///8A////AP///wD///8A////AP///wD///8A////AP///wD///8A////
AP///wD///8A////AP///wD///8A////AP///wD///8A////AP///wD///8A////AP///wD///8A
////AP///wD///8A////AP///wD///8A////AP///wAAAAD/AAAA/////wD///8A////AP///wD/
//8AAAAA/wAAAP////8A////AP///wD///8A////AP///wD///8A////AP///wD///8A////AP//
/wD///8A////AP///wD///8A////AP///wD///8A////AP///wD///8A////AP///wD///8A////
AP///wD///8A////AP///wD///8A////AAAAAP8AAAD/////AP///wD///8A////AP///wD///8A
////AP///wD///8A////AP///wD///8A////AP///wD///8A////AP///wD///8A////AP///wD/
//8A////AP///wD///8A////AP///wD///8A////AP///wD///8A////AP///wD///8A////AP//
/wD///8A////AP///wD///8A////AP///wD///8A////AP///wD///8A////AP///wD///8A////
AP///wD///8A////AP///wD///8A////AP///wAAAAD/AAAA/////wD///8A////AP///wD///8A
////AP///wAAAAD/AAAA/////wD///8A////AP///wD///8A////AP///wD///8A////AP///wD/
//8A////AP///wD///8A////AP///wD///8A////AP///wD///8A////AP///wD///8A////AP//
/wD///8A////AP///wD///8A////AP///wAAAAD/AAAA/wAAAP8AAAD/AAAA/wAAAP8AAAD/AAAA
/wAAAP8AAAD/AAAA/wAAAP8AAAD/AAAA/wAAAP8AAAD/AAAA/wAAAP8AAAD/AAAA/wAAAP8AAAD/
AAAA/wAAAP8AAAD/AAAA/wAAAP////8A////AAAAAP8AAAD/AAAA/wAAAP8AAAD/AAAA/wAAAP8A
AAD/AAAA/wAAAP8AAAD/AAAA/wAAAP8AAAD/AAAA/wAAAP8AAAD/AAAA/wAAAP8AAAD/AAAA/wAA
AP8AAAD/AAAA/wAAAP8AAAD/AAAA/wAAAP8AAAD/AAAA/wAAAP8AAAD/////AP///wD///8A////
AP///wAAAAD/AAAA/wAAAP8AAAD/AAAA/wAAAP8AAAD/AAAA/wAAAP8AAAD/AAAA/wAAAP8AAAD/
AAAA/wAAAP8AAAD/AAAA/wAAAP8AAAD/AAAA/wAAAP8AAAD/AAAA/wAAAP8AAAD/AAAA/wAAAP8A
AAD/AAAA/wAAAP8AAAD/AAAA/wAAAP8AAAD/AAAA/wAAAP8AAAD/AAAA/wAAAP8AAAD/AAAA/wAA
AP8AAAD/AAAA/wAAAP8AAAD/AAAA/wAAAP8AAAD/AAAA/wAAAP8AAAD/AAAA/wAAAP8AAAD/AAAA
/wAAAP8AAAD/AAAA/wAAAP8AAAD/////AP///wAAAAD/AAAA/wAAAP8AAAD/AAAA/wAAAP8AAAD/
AAAA/wAAAP8AAAD/AAAA/wAAAP8AAAD/AAAA/wAAAP8AAAD/AAAA/wAAAP8AAAD/AAAA/wAAAP8A
AAD/AAAA/wAAAP8AAAD/AAAA/wAAAP8AAAD/AAAA/wAAAP8AAAD/AAAA/wAAAP////8A////AP//
/wAAAAD/AAAA/wAAAP8AAAD/AAAA/wAAAP8AAAD/AAAA/wAAAP8AAAD/AAAA/wAAAP8AAAD/AAAA
/wAAAP8AAAD/AAAA/wAAAP8AAAD/AAAA/wAAAP8AAAD/AAAA/wAAAP8AAAD/AAAA/wAAAP8AAAD/
AAAA/wAAAP8AAAD/AAAA/wAAAP8AAAD/AAAA/wAAAP8=
